jim	MALE
huck	MALE
mary jane	FEMALE
sally	FEMALE
miss watson	FEMALE
silas	MALE
sid	MALE
huck finn	MALE
peter	MALE
george	MALE
harvey	MALE
william	MALE
sherburn	MALE
thatcher	MALE
bill	MALE
dey	UNKNOWN
mars tom	
boggs	MALE
bob	MALE
harney	UNKNOWN
