anne	FEMALE
marilla	MALE
diana	
matthew	
mrs lynde	FEMALE
gilbert	MALE
jane	FEMALE
josie pye	FEMALE
ruby gillis	
miss stacy	FEMALE
mrs allan	FEMALE
miss barry	FEMALE
mrs barry	FEMALE
mr phillips	MALE
mrs spencer	FEMALE
mrs thomas	FEMALE
carmody	MALE
moody spurgeon	
mr bell	MALE
cordelia	FEMALE
charlie sloane	MALE
mrs blewett	FEMALE
mr barry	MALE
minnie may	
prissy andrews	MALE
elaine	FEMALE
mrs hammond	FEMALE
mr allan	MALE
geraldine	FEMALE
gil	FEMALE
