ned	MALE
cora	
nathan	MALE
humphrey	MALE
jack	MALE
rupert	MALE
mark	MALE
gollop	FEMALE
heathman	FEMALE
dennis	
vivian	MALE
timothy	MALE
milly	FEMALE
thomas	MALE
susan	FEMALE
joe voysey	MALE
mrs lintern	FEMALE
mr gollop	MALE
priscilla	FEMALE
phyllis	FEMALE
mr head	MALE
mr masterman	MALE
mrs hacker	FEMALE
hawk house	MALE
nat	MALE
hester	MALE
mrs baskerville	FEMALE
miss masterman	MALE
cadworthy	UNKNOWN
polly	FEMALE
st george	MALE
mr voysey	MALE
shaugh	UNKNOWN
tom	
mr luscombe	MALE
saul luscombe	MALE
mr popham	MALE
baskervilles	UNKNOWN
